{
  "tileset": "forest",

  "width": 48,
  "height": 44,
  "scrolling": true,

"tiles": [
    [  4,  5,  4,  5,  4,  5,  4,  5,  4,  5,  4,  5,  8,  9,  2,  2,  8,  9,  4,  5,  4,  5,  4,  5,  4,  5,  4,  5,  4,  5,  4,  5,  4,  5,  4,  5,  4,  5,  4,  5,  4,  5,  4,  5,  4,  5,  4,  5 ],
    [  8,  9,  8,  9,  8,  9,  8,  9,  8,  9,  8,  9,  4,  5,  2,  2,  4,  5,  8,  9,  8,  9,  8,  9,  8,  9,  8,  9,  8,  9,  8,  9,  8,  9,  8,  9,  8,  9,  8,  9,  8,  9,  8,  9,  8,  9,  8,  9 ],
    [  4,  5,  4,  5,  4,  5,  4,  5,  4,  5,  4,  5,  8,  9,  2,  2,  8,  9,  4,  5,  4,  5,  4,  5,  4,  5,  4,  5,  4,  5,  4,  5,  4,  5,  4,  5,  4,  5,  4,  5,  4,  5,  4,  5,  4,  5,  4,  5 ],
    [  8,  9,  8,  9,  8,  9,  8,  9,  8,  9,  8,  9,  4,  5,  2,  2,  4,  5,  8,  9,  8,  9,  8,  9,  8,  9,  8,  9,  8,  9,  8,  9, 12, 13, 12, 13, 12, 13, 12, 13, 12, 13, 12, 13, 12, 13,  8,  9 ],
    [  4,  5,  4,  5,  4,  5,  4,  5,  4,  5,  4,  5, 12, 13,  2,  2, 12, 13,  4,  5,  4,  5,  4,  5,  4,  5,  4,  5,  4,  5,  4,  5,  2,  2,  2,  2,  2,  2,  2,  2,  2,  2,  2,  2,  2,  2,  4,  5 ],
    [  8,  9,  8,  9,  8,  9,  8,  9,  8,  9,  8,  9, 10, 10,  6,  6, 10, 10,  8,  9,  8,  9,  8,  9,  8,  9, 12, 17, 16, 17, 16, 13,  2,  2,  2,  2,  2,  0,  1,  0,  1,  2,  2,  2,  2,  2,  8,  9 ],
    [  4,  5,  4,  5,  4,  5,  4,  5,  4,  5,  4,  5,  2,  2,  2,  2,  2,  2,  4,  5,  4,  5,  4,  5,  4,  5,  2,  4,  5,  4,  5,  2,  2,  2,  2,  2,  2,  4,  5,  4,  5,  2,  2,  2,  2,  2,  4,  5 ],
    [  8,  9,  8,  9, 12, 13, 12, 13, 12, 13, 12, 13,  2,  2,  2,  2,  2,  2,  8,  9,  8,  9,  8,  9, 12, 13,  2, 12, 13, 12, 13,  2,  2,  2,  2,  2,  2,  8,  9,  8,  9,  2,  2,  2,  2,  2,  8,  9 ],
    [  4,  5,  4,  5,  2,  2,  2,  2,  2,  2,  2,  3,  2,  2,  2,  2,  2,  2,  4,  5,  4,  5,  4,  5,  2,  2,  2,  2,  2,  2,  2,  2,  2,  2,  2,  2,  2,  4,  5,  4,  5,  7, 11, 11, 11, 15,  4,  5 ],
    [  8,  9,  8,  9,  2,  2,  2,  2,  2,  2,  2,  2,  2,  2,  2,  2,  2,  2, 12, 13, 12, 13, 12, 13,  2,  2,  2,  2,  0,  1,  0,  1,  0,  1,  2,  2,  2, 12, 13, 12, 13,  2,  2,  2,  2,  2,  8,  9 ],
    [  4,  5,  4,  5,  2,  2,  2,  2,  2,  2,  2,  2,  2,  2,  2,  2,  2,  2,  2,  2,  2,  2,  2,  2,  2,  2,  2,  2,  4,  5,  4,  5,  4,  5,  2,  2,  2,  2,  2,  2,  2,  2,  2,  2,  2,  2,  4,  5 ],
    [  8,  9,  8,  9,  2,  2,  2,  2,  0,  1,  0,  1,  0,  1,  2,  2,  2,  2,  0,  1,  0,  1,  0,  1,  0,  1,  0,  1,  8,  9,  8,  9,  8,  9,  0,  1,  0,  1,  0,  1,  2,  2,  2,  2,  2,  2,  8,  9 ],
    [  4,  5,  4,  5,  2,  2,  2,  2,  4,  5,  4,  5,  4,  5,  2,  2,  2,  2,  4,  5,  4,  5,  4,  5,  4,  5,  4,  5,  4,  5,  4,  5,  4,  5,  4,  5,  4,  5,  4,  5,  2,  2,  2,  2,  2,  2,  4,  5 ],
    [  8,  9,  8,  9,  2,  2,  2,  2,  8,  9,  8,  9,  8,  9,  2,  2,  2,  2, 12, 17, 16, 17, 16, 17, 16, 17, 16, 17, 16, 17, 16, 17, 16, 17, 15, 17, 16, 17, 16, 17,  1,  2,  2,  2,  2,  2,  8,  9 ],
    [  4,  5,  4,  5,  2,  2,  2,  2,  4,  5,  4,  5,  4,  5,  7, 11, 11, 11, 15,  4,  5,  4,  5,  4,  5,  4,  5,  4,  5,  4,  5,  4,  5,  4,  5,  4,  5,  4,  5,  4,  5,  2,  2,  2,  2,  2,  4,  5 ],
    [  8,  9,  8,  9,  2,  2,  2,  2, 12, 13, 12, 13, 12, 13,  2,  2,  2,  2,  2, 12, 13, 12, 13, 12, 13, 12, 13, 12, 17, 16, 17, 16, 17, 16, 17, 16, 17, 16, 17, 16, 17,  1,  2,  2,  2,  2,  8,  9 ],
    [  4,  5,  4,  5,  2,  2,  2,  2,  2,  2,  2,  2,  2,  2,  2,  2,  2,  2,  2,  2,  2,  2,  2,  2,  2,  2,  2,  2,  4,  5,  4,  5,  4,  5,  4,  5,  4,  5,  4,  5,  4,  5,  2,  2,  2,  2,  4,  5 ],
    [  8,  9,  8,  9,  2,  2,  2,  2,  2,  2,  2,  2,  2,  2,  2,  2,  2,  2,  2,  2,  2,  2,  2,  2,  2,  2,  2,  2,  8,  9,  8,  9,  8,  9,  8,  9,  8,  9,  8,  9,  8,  9,  2,  2,  2,  2,  8,  9 ],
    [  4,  5,  4,  5,  2,  2,  2,  2,  2,  2,  2,  2,  2,  2,  2,  2,  2,  2,  2,  2,  2,  2,  2,  2,  2,  2,  2,  2,  4,  5,  4,  5,  4,  5,  4,  5,  4,  5,  4,  5,  4,  5,  2,  2,  2,  2,  4,  5 ],
    [  8,  9,  8,  9,  2,  2,  2,  2,  2,  2,  2,  2,  2,  2,  2,  2,  2,  2,  2,  2,  2,  2,  2,  2,  2,  2,  2,  2,  8,  9,  8,  9,  8,  9, 12, 13,  8,  9,  8,  9,  8,  9,  2,  2,  2,  2,  8,  9 ],
    [  4,  5,  4,  5,  2,  2,  2,  2,  2,  2,  2,  2,  2,  2,  2,  2,  2,  2,  2,  2,  2,  2,  2,  2,  2,  2,  2,  2,  4,  5,  4,  5,  4,  5,  2,  2,  4,  5,  4,  5,  4,  5,  7, 11, 11, 15,  4,  5 ],
    [  8,  9,  8,  9,  2,  2,  2,  2,  2,  2,  2,  2,  2,  2,  2,  2,  2,  2,  2,  2,  2,  2,  2,  2,  2,  2,  2,  2,  8,  9,  8,  9, 12, 13,  2,  2, 12, 13,  8,  9,  8,  9,  2,  2,  2,  2,  8,  9 ],
    [  4,  5,  4,  5,  2,  2,  2,  2,  2,  2,  2,  2,  2,  2,  2,  2,  2,  2,  2,  2,  2,  2,  2,  2,  2,  2,  2,  2,  4,  5,  4,  5,  2,  2,  2,  2,  2,  2,  4,  5,  4,  5,  2,  2,  2,  2,  4,  5 ],
    [  8,  9,  8,  9,  2,  2,  2,  2,  2,  2,  2,  2,  2,  2,  2,  2,  2,  2,  2,  2,  2,  2,  2,  2,  2,  2,  2,  2,  8,  9,  8,  9,  2,  2,  2,  2,  2,  2, 12, 13, 12, 13,  2,  2,  2,  2,  8,  9 ],
    [  4,  5,  4,  5,  2,  2,  2,  2,  2,  2,  2,  2,  2,  2,  2,  2,  2,  2,  2,  2,  2,  2,  2,  2,  2,  2,  2,  2,  4,  5,  4,  5,  2,  2,  2,  2,  2,  2,  2,  2,  2,  2,  2,  2,  2,  2,  4,  5 ],
    [  8,  9,  8,  9,  2,  2,  2,  2,  2,  2,  2,  2,  2,  2,  2,  2,  2,  2,  2,  2,  2,  2,  2,  2,  2,  2,  2,  2,  8,  9,  8,  9,  2,  2,  2,  2,  0,  1,  2,  2,  2,  2,  2,  2,  2,  2,  8,  9 ],
    [  4,  5,  4,  5,  2,  2,  2,  2,  2,  2,  2,  2,  2,  2,  2,  2,  2,  2,  2,  2,  2,  2,  2,  2,  2,  2,  2,  2,  4,  5,  4,  5,  2,  2,  2,  2,  4,  5,  2,  2,  2,  2,  2,  2,  2,  2,  4,  5 ],
    [  8,  9,  8,  9,  2,  2,  2,  2,  2,  2,  2,  2,  2,  2,  2,  2,  2,  2,  2,  2,  2,  2,  2,  2,  2,  2,  2,  2,  8,  9,  8,  9,  2,  2,  2,  2,  8,  9,  0,  1,  2,  2,  2,  2,  0,  1,  8,  9 ],
    [  4,  5,  4,  5,  2,  2,  2,  2,  2,  2,  2,  2,  2,  2,  2,  2,  2,  2,  2,  2,  2,  2,  2,  2,  2,  2,  2,  2,  2,  2,  2,  2,  2,  2,  2,  2,  4,  5,  4,  5,  2,  2,  2,  2,  4,  5,  4,  5 ],
    [  8,  9,  8,  9,  2,  2,  2,  2,  2,  2,  2,  2,  2,  2,  2,  2,  2,  2,  2,  2,  2,  2,  2,  2,  2,  2,  2,  2,  2,  2,  2,  2,  2,  2,  2,  2,  8,  9,  8,  9,  0,  1,  0,  1,  8,  9,  8,  9 ],
    [  4,  5,  4,  5,  2,  2,  2,  2,  2,  2,  2,  2,  2,  2,  2,  2,  2,  2,  2,  2,  2,  2,  2,  2,  2,  2,  2,  2,  2,  2,  2,  2,  2,  2,  2,  2,  4,  5,  4,  5,  4,  5,  4,  5,  4,  5,  4,  5 ],
    [  8,  9,  8,  9,  2,  2,  2,  2,  2,  2,  2,  2,  2,  2,  2,  2,  2,  2,  2,  2,  2,  2,  2,  2,  2,  2,  2,  2,  2,  2,  2,  2,  2,  2,  2,  2,  8,  9,  8,  9,  8,  9,  8,  9,  8,  9,  8,  9 ],
    [  4,  5,  4,  5,  2,  2,  2,  2,  2,  2,  2,  2,  2,  2,  2,  2,  2,  2,  2,  2,  2,  2,  2,  2,  2,  2,  2,  2,  2,  2,  2,  2,  2,  2,  2,  2,  4,  5,  4,  5,  4,  5,  4,  5,  4,  5,  4,  5 ],
    [  8,  9,  8,  9,  2,  2,  2,  2,  2,  2,  2,  2,  2,  2,  2,  2,  2,  2,  2,  2,  2,  2,  2,  2,  2,  2,  2,  2,  2,  2,  2,  2,  2,  2,  2,  2,  8,  9,  8,  9,  8,  9,  8,  9,  8,  9,  8,  9 ],
    [  4,  5,  4,  5,  2,  2,  2,  2,  2,  2,  2,  2,  2,  2,  2,  2,  2,  2,  2,  2,  2,  2,  2,  2,  2,  2,  2,  2,  2,  2,  2,  2,  2,  2,  2,  2,  2,  2,  2,  2,  2,  2,  4,  5,  4,  5,  4,  5 ],
    [  8,  9,  8,  9,  2,  2,  2,  2,  2,  2,  2,  2,  2,  2,  2,  2,  2,  2,  2,  2,  2,  2,  2,  2,  2,  2,  0,  1,  0,  1,  0,  1,  0,  1,  2,  2,  2,  2,  2,  2,  2,  2,  8,  9,  8,  9,  8,  9 ],
    [  4,  5,  4,  5,  2,  2,  2,  2,  2,  2,  2,  2,  2,  2,  2,  2,  2,  2,  2,  2,  2,  2,  2,  2,  2,  2,  2,  2,  2,  2,  2,  2,  2,  2,  2,  2,  2,  2,  2,  2,  2,  2,  4,  5,  4,  5,  4,  5 ],
    [  8,  9,  8,  9,  2,  2,  2,  2,  2,  2,  2,  2,  2,  2,  2,  2,  2,  2,  2,  2,  2,  2,  2,  2,  2,  2,  2,  2,  2,  2,  2,  2,  2,  2,  2,  2,  2,  2,  2,  2,  0,  1,  8,  9,  8,  9,  8,  9 ],
    [  4,  5,  4,  5,  2,  2,  2,  2,  2,  2,  2,  2,  2,  2,  2,  2,  2,  2,  2,  2,  2,  2,  2,  2,  2,  2,  2,  2,  2,  2,  2,  2,  2,  2, 10, 10,  6,  6, 10, 10,  4,  5,  4,  5,  4,  5,  4,  5 ],
    [  8,  9,  8,  9,  2,  2,  2,  2,  2,  2,  2,  2,  2,  2,  2,  2,  2,  2,  2,  2,  2,  2,  2,  2,  2,  2,  2,  2,  2,  2,  2,  2,  2,  2,  0,  1,  2,  2,  0,  1,  8,  9,  8,  9,  8,  9,  8,  9 ],
    [  4,  5,  4,  5,  4,  5,  4,  5,  4,  5,  4,  5,  4,  5,  4,  5,  4,  5,  4,  5,  4,  5,  4,  5,  4,  5,  4,  5,  4,  5,  4,  5,  4,  5,  4,  5,  2,  2,  4,  5,  4,  5,  4,  5,  4,  5,  4,  5 ],
    [  8,  9,  8,  9,  8,  9,  8,  9,  8,  9,  8,  9,  8,  9,  8,  9,  8,  9,  8,  9,  8,  9,  8,  9,  8,  9,  8,  9,  8,  9,  8,  9,  8,  9,  8,  9,  2,  2,  8,  9,  8,  9,  8,  9,  8,  9,  8,  9 ],
    [  4,  5,  4,  5,  4,  5,  4,  5,  4,  5,  4,  5,  4,  5,  4,  5,  4,  5,  4,  5,  4,  5,  4,  5,  4,  5,  4,  5,  4,  5,  4,  5,  4,  5,  4,  5,  2,  2,  4,  5,  4,  5,  4,  5,  4,  5,  4,  5 ],
    [  8,  9,  8,  9,  8,  9,  8,  9,  8,  9,  8,  9,  8,  9,  8,  9,  8,  9,  8,  9,  8,  9,  8,  9,  8,  9,  8,  9,  8,  9,  8,  9,  8,  9,  8,  9,  2,  2,  8,  9,  8,  9,  8,  9,  8,  9,  8,  9 ]
  ],

  "warps": [ 
    { 
      "x": 0, "y": 0, 
      "width": 16, "height": 16, 
      "to_room": "room2", 
      "dest_x": 80, "dest_y": 80, 
      "dest_facing": "up" 
    } 
  ]
}
